Physics demo map:-4.5
                                                                                   *******
                                                                                  ********
        **"     *                                               "  "              ********
  *" " *****" "***"  "" "                                    ""*****  H         "*********
***************************     H          "  "    "   "    *****     H       "***********
*****  ***@  "  "               H        "*******H***********         H      "************
*******************         "   H  "  ***** ** **H*****     " "       H      *************
********** ***********"   ****  H ******* *******H "        ***    "  H "    E************
************ *** *******    * ****  *** ****   *******    *** ****************************
**************************                             ********* ******** ****************
******* ************* ************           ************  ***************** *************
**************** *** ********* ********* *** ***** **************** *********** **** *****
************************* *********   * *   ** ******** ****************** ***************
***********************************   *      **************** ******* ********* **********
***********************************   *      ******  *********** ********* ***************
***********************************   *      *********************** ******* *************