Physics demo map:-6.5
                                                                                       _SSSSSSSS
        _       _                                                                    __SSSSSSSSS
        SS _    S_                                   _ _   __   _  _                 SSSSSSSSSSS
  S_ _ SSS@S_1_SSS_  __S_                           HSSSSSSSSSSSSSSS  H             _SSSSSSSSSSS
SSSSSS SSS SSSSSSSSSSSSSSSS     H          _  _    _H                 H      H     _SSSSSSSSSSSS
SSSSS _SSS   _  _         H     H       __ SSSSSSHSSSSS               H      H     SSSSSSSSSSSSS
SSSSSSSSSSSSSSSSSSS       H _   H  _  _SSSHSSS SSH    S         __    H      H     SSSSSSSS1SSSS
SSSSSSSSSSSSSSSSSSSSSSSSSSHSSS 1H_ SSSSS  H HSSSSH1_        _ _ SS _  H _    H1 S  ESS _  _  SSS
SSSSSSSSSSSS SSS S SSSSSSSHSSSSSSSSS  1   H H  SSHSSS    _ _SSSSSSSSSSSSSSSSSSSSSSSSSSSSSSSSSSSS
SSSSSSSSSSSSSSSSSSSSSSSSSSH    H            H    H    __ SSSS SS SSSSSSSS SSSSSSSSSSSSSSSSSSSSSS
SSSSSSS SSSSS SSSSSSSS S SH    H    SSSSSSS H       _ SSSS SSSSSSSSSSSSSSSSSSSSSSS SSSSSSSSSSSSS
SSSSSSS SSSSSSSSSSSSSSSSSSH    H SSSSH      H      SSSSSSS SSSSSSSSSSSSSSSSSSSSSSS SSSSSSSSSSSSS
SSSSSSS SSSSSSSSSSSSSSSSSSSSSS H     H      H    SSSSSSSSS SSSSSSSSSSSSSSSSSSSSSSS SSSSSSSSSSSSS
SSSSSSSSSSSSSSSS SS              1 +    1  1 1 SSS SSSSSSSSSSSSSSSS SSSSSSSSSSSSSSSSS SSSS SSSSS
SSSSSSSSSSSSSSSSSSS     1 SSSSSSSSSSSSSSSSSSSSSSSSSSSSS SSSSSSSSSSSSSSSSSS SSSSSSSSSSSSSSSSSSSSS
SSSSSSSSSSSSSSSSSSSSSSSSSSSSSS                SSSSSSSSSSSSSSS SSSSSSS SSSSSSSSSSSSSSS SSSSSSSSSS
SSSSSSSSSSSSSSSSSSSSSSSSSSSS                    SSS  SSSSSSSSSSS SSSSSSSSS SSSSSSSSSSSSSSSSSSSSS
SSSSSSSSSSSSSSSSSSSSSSSSSSSSSS    S              SSSSSSSSSSSSSSSSSSS SSSSSSSSSSSSS SSSSSSSSSSSSS
SSSSSSSSSSSSSSSSSSSSSSSSSSSSSSSSSSS             SSSSSSSSSSSSS SSSSSSS SSSSSSSSSSSSSSS SSSSSSSSSS
SSSSSSSSSSSSSSSSSSSSSSSSSSSSSS                SSSSSSSSSSSSSSS SSSSSSS SSSSSSSSSSSSSSS SSSSSSSSSS
SSSSSSSSSSSSSSSSSSSSSSSSSSSSSS                SSSSSSSSSSSSSSS SSSSSSS SSSSSSSSSSSSSSS SSSSSSSSSS
SSSSSSSSSSSSSSSSSSSSSSSSSSSSSS                SSSSSSSSSSSSSSS SSSSSSS SSSSSSSSSSSSSSS SSSSSSSSSS
