Physics demo map:-4.5
                                                                                         "******
        "       "                                                                       "*******
        **"     *"                                              "  "                   "********
  *" " *****"1"***"  ""*"                                    ""*****  H              ""*********
***************************     H          "  "    "   "  ""*****     H      H      "****1******
*****  ***@  "  "               H        "*******H***********         H      H     "*****   ****
*******************         "   H  "  ***** ** **H* ***      ""       H      H     ******** ****
********** ***********"   ****  H **** **********H " "       **    "  H " 1  H  *  E****     ***
************ *** *******    * ****   ***  *    *******    *** **********************************
**************************                             ********* ******** **********************
******* ************* *************    1    *************  *********************** *************
**************** *** ********* ******************* **************** ***************** **** *****
************************* *********  ****   ** ******** ****************** *********************
***********************************   *      **************** ******* *************** **********
***********************************   *      ******  *********** ********* *********************
***********************************   *      *********************** ************* *************