Random name for a map!:-10
**********                                                                                *********
**********                                                                                *********
**********                                                                                *********
******* **                                                           **************       *********
******* **                                                  ******                    *************
******* *    @                                                                   ******************
********* *****       *****                               ****      *******     *******************
********* ********     *************      *************          ************             *********
********* **********                   ************        **************************       *******
********* *************************************           ******                       ************
******* * *******************************            *********    *********************************
******* * ****         ***          ****      **************    ***********************************
*******                                    ***************    *************************************
*********************        ***************************    ***************************************
***************************                               *****************************************
***************************************************************************************************
***************************************************************************************************
***************************************************************************************************
***************************************************************************************************
***************************************************************************************************
***************************************************************************************************
