Level 1:-100

******                   ******
****** @          E      ******
*******************************
*******************************
*******************************
*******************************
*******************************
*******************************
