Level 1:-100
S                                                                    HSSSSSSSSSSSSS      SSSSSS
S                                                                    H                   SSSSSS
S                                                                    H                   SSSSSS
S                                                                    H                  ESSSSSS
S                                                                    H                  HS
S                                                                    H                  HS
S                                                                    H                  HS
S                                                                    H                  HS
S                                                                  HSSS                 HS
S                                                                  H                    HS
S                                                                  H                    HS
S                                                                  H                    HS
S                                                                  H                    HS
S                                                                  H                    HS
S                  SSSSH            SS                    HSSSSSS  H                    HS
S @            1                SS   1         1                                        HS
SSSSSSSSSSSSSSSSSSSSSSSSSSSSSSSSSSSSSSSSSSSSSSSSSSSSSSSSSSSSSSSSSSSSSSSSSSSSSSSSSSSSSSSSSS